00000000000044477444000000000000
00000000000044477444000000000000
00000000000044477444000000000000
00000000000044477444000000000000
00000000000044477444000000000000
00000000000044477444000000000000
00000000000044477444000000000000
00000000000044477444000000000000
00000000000044477444000000000000
00000000000044477444000000000000
00000000000044477444000000000000
00000000000044477444000000000000
00000000000044477442333333333333
00000000000042277223333333333333
00000000000042277223333333333333
66666666666666655666666666666666
66666666666666655666666666666666
33333333333322277223333333333333
33333333333322277223333333333333
00000000000044477442333333333333
00000000000044477444000000000000
00000000000044477444000000000000
00000000000044477444000000000000
00000000000044477444000000000000
00000000000044477444000000000000
00000000000044477444000000000000
00000000000044477444000000000000
00000000000044477444000000000000
00000000000044477444000000000000
00000000000044477444000000000000
00000000000044477444000000000000
00000000000044477444000000000000