0000000000004447744400000000000000000000000044477444000000000000
0000000000004447744400000000000000000000000044477444000000000000
0000000000004447744400000000000000000000000044477444000000000000
0000000000004447744400000000000000000000000044477444000000000000
0000000000004447744400000000000000000000000044477444000000000000
0000000000004447744400000000000000000000000044477444000000000000
0000000000004447744400000000000000000000000044477444000000000000
0000000000004447744400000000000000000000000044477444000000000000
0000000000004447744400000000000000000000000044477444000000000000
0000000000004447744400000000000000000000000044477444000000000000
0000000000004447744400000000000000000000000044477444000000000000
0000000000004447744400000000000000000000000044477444000000000000
0000000000004447744233333333333300000000000044477444000000000000
0011002200330044005500660077008800990000001100220033004400550066
0011002200330044005500660077008800990000001100220033004400550066
0011002200330044005500660077008800990000001100220033004400550066
0011002200330044005500660077008800990000001100220033004400550066
3333333333332227722333333333333300000000000044477444000000000000
3333333333332227722333333333333300000000000044477444000000000000
0000000000004447744233333333333300000000000044477444000000000000
0000000000004447744400000000000000000000000044477444000000000000
0000000000004447744400000000000000000000000044477444000000000000
0000000000004447744400000000000000000000000044477444000000000000
0000000000004447744400000000000000000000000044477444000000000000
00000000000044477444000000S0S8SGSO000000000044477444000000000000
00000000000044477444000000S1S9SHSP000000000044477444000000000000
00000000000044477444000000S2SASISQ000000000044477444000000000000
00000000000044477444000000S3SBSJSR000000000044477444000000000000
00000000000044477444000000S4SCSKSS000000000044477444000000000000
00110022003300440055006600S5SDSLST990000001100220033004400550066
00110022003300440055006600S6SESMSU990000001100220033004400550066
00110022003300440055006600S7SFSNSV990000001100220033004400550066