0000000100000001000000010000000200000001000000010000000100000001
0000000100000001000000010000000200000001000000010000000100000001
0000000100000001000000010000000200000001000000010000000100000001
0000000100000001000000010000000200000001000000010000000100000001
0000000100000001000000010000000200000001000000010000000100000001
0000000100000001000000010000000200000001000000010000000100000001
0000000100000001000000010000000200000001000000010000000100000001
0000000100000001000000010000000200000001000000010000000100000001
0000000100000001000000010000000200000001000000010000000100000001
0000000100000001000000010000000200000001000000010000000100000001
0000000100000001000000010000000200000001000000010000000100000001
0000000100000001000000010000000200000001000000010000000100000001
0000000100000001000000010000000200000001000000010000000100000001
0000000111111111111111111111111211111111111111111111111100000001
0000000111111111111111111111111211111111111111111111111100000001
0000000111111111111111111111111311111111111111111111111100000001
0000000111111111111111111111111211111111111111111111111100000001
0000000100000001000000010000000200000001000000010000000100000001
0000000100000001000000010000000200000001000000010000000100000001
0000000100000001000000010000000200000001000000010000000100000001
0000000100000001000000010000000200000001000000010000000100000001
0000000100000001000000010000000200000001000000010000000100000001
0000000100000001000000010000000200000001000000010000000100000001
0000000100000001000000010000000200000001000000010000000100000001
0000000100000001000000010000000200000001000000010000000100000001
0000000100000001000000010000000200000001000000010000000100000001
0000000100000001000000010000000200000001000000010000000100000001
0000000100000001000000010000000200000001000000010000000100000001
0000000100000001000000010000000200000001000000010000000100000001
0000000100000001000000010000000200000001000000010000000100000001
0000000100000001000000010000000200000001000000010000000100000001
0000000100000001000000010000000200000001000000010000000100000001